
SO ./assets/so.xpm   
EA ./assets/ea.xpm   
WE ./assets/we.xpm
NO ./assets/no.xpm
F  45,0006,5
C  0,25,51



11111111111111111111
10000000000000000001
10010000100100001001
10100000000010000101
10000000N00000000001
10000000000000000001
10100000100010000101
10010000000000001001
11111111111111111111