SO ./assets/wall64.png
WE ./assets/wall64.png
EA ./assets/wall64.png
NO ./assets/anas.png
F 0,0,31
C 40,40,40

111111111111111111111111111111111        1111111111111111111111111
100000001000000000110000000000001        1000000000110000000000001
100000001011000001110000000000001        1011000001110000000000001
100001111001000000000000000000001        1001000000000000000000001
100011111011000001110000000000001111111111011000001110000000000001
1000000D0000000000000000000000000000000D00000000000000000000000001
1111011111111101110000001000111000011111111D1110000001000101000101
1111D111111111D11101010010001111D110000000000110101001000101000101
11000000110101011100000010101110001000000K001110000001000101000101
100000000000000011000000100000000000000000000110000001000101000101
10000000000000001101010010001100000000N000000110101001000101000101
110000011101010111110111100011110000111110101111110111101111101111
11110111 1110101 10111101000111100111 1110101 10111101000101000101
1111D111 1111111 111111111111111D1111 1111111 111111111D1111111111
111101111111110111000000100011100001111111101110000001000101000101
111101111111110111010100100011110111111111101110101001000101000101
11000000000000000000000010101110001001101010111000000D000101000101
1000000000000000110000001000D0000000000000000110000001000101000101
100000000000000011010100101011000000000000000110101001000101000101
110000011101010111110111100011110000111110101111110111101111101111
10110111 1110101 10111101000111100111 1110101 10111101000101001001
11111111 1111111 11111111111111111111 1111111 11111111111111111111