SO ./assets/wall/wall64.png 
WE ./assets/wall/wall64.png
EA ./assets/wall/wall64.png
NO ./assets/wall/wall64.png
F 0,0,31
C 40,40,40

                       1111111
                       100001
                       100001
11111111111111111      100001
10000010D00000001      100001
10001000100110001      100001
11111111100010001111111100001111111111111
1010100000000000D000000000000000000000001
10000000010110001111111100000000000010001
10101000010010001      100000000001110001
11101111111110001      100000000000010001
10000000DDD000001      111111111111110001
1E000000111000001                   10001
11111111111111111                   10001
                          111111111110001
                          100000000000001
                          111111111100001
                                   111111