SO ./assets/wall/wall64.png
WE ./assets/wall/wall64.png
EA ./assets/wall/wall64.png
NO ./assets/wall/wall64.png
C 0,0,0
F 40,40,40


1111111111111111111111111111111111111111111111111
1000000000110000000000001000000000000000000000001
101100000111000000000000D000000000000000000000001
101100000000000000000000100000000000000000000001
101100000111000000000000100000000000000000000001
1000000000110000011101111000100000000E00000000001
111101111111110111000000100000000000000000000001
111101111111110111000000100000000000000000000001
110000001101010111010100100000000000000000000001
10000000000000001100100011D1111111111111111111111
10000000000000001100000000001
11111111111111000000000000001
11111111111111000000000000001
10000000000000001111000000001
10000000000000011111000000001
11111111111000000001111110001
10000000000000000001000000001
10000000000000000001010000001
11111111111111111111111111111
