SO ./assets/wall/blossom.png
WE ./assets/wall/flower.png
EA ./assets/wall/night.png
NO ./assets/wall/olives.png
F 0,0,31
C 0,0,50


1111111111111111111111111111111111111111111
1000000000000000111111110000000000000000001
1000000000000000111111110000000000000110001
1000000000000000000000000000000000000010001
1000000000000000000000000000000000000000001
1000000000000000111111110000000000000000001
1000000000000000111111110000000000000000001
1111111000111111111111111111111111111111111
10000000000000000000000000001
10000000000000000000000100001
10000000000000000000000100001
11110001111111100001111111111
10000000000000000000000100001
10000000000000000000000100001
10000000000000000000000100001
11111111111111110011111111111
10000000000000000000000100001
1000000000000000000N000100001
10000000000000000000000000001
11111111111111111111D11111111
10000000000000000000000100001
10000000000000000000000100001
10000000000000000000000100001
11111111111111111111111111111
