SO ./assets/14.png
WE ./assets/14.png
EA ./assets/14.png
NO ./assets/14.png
F 0,0,31
C 0,0,50


1111111111111111111111111111111111111111111111111
1000000000110000000000000000000000000000000000001
101100000111000000000000100000000000000000000001
101100000000000000000000100000000000000000000001
101100000111000000000000100000000000000000000001
1000000000110000011101111000100000000E00000000001
111101111111110111000000100000000000000000000001
111101111111110111000000100000000000000000000001
110000001101010111010100100000000000000000000001
100000000000000011001000100011111111111111111111
10000000000000001100000000001
11111111111111000000000000001
11111111111111000000000000001
10000000000000001111000000001
10000000000000011111000000001
11111111111000000001111110001
10000000000000000001000000001
10000000000000000001010000001
11111111111111111111111111111