SO ./assets/wall/blossom.png
WE ./assets/wall/flower.png
EA ./assets/wall/night.png
NO ./assets/wall/olives.png
F 0,0,31
C 0,0,50


11111111111111111111
10000001111111100001
10000000000000000001
10000000000000000001
10000001000000100001
11111111000000111111
10000000000000000001
10000001000000100001
10000001000000100001
11110001111111100001
10000000000000100001
10000000000000100001
10000000000000000001
11111000000000111111
10000000000000100001
10000000000000100001
10000000000000000001
11111111000000101111
10000000000000100001
10000000000000100001
10W00000000000100001
11111111111111111111
