SO ./assets/wall64.png
WE ./assets/wall64.png
EA ./assets/wall64.png
NO ./assets/wall/redbrick.png
F 0,0,31
C 40,40,40


1111111111111111111111111111111111111111111111111
100000000011000000000000D000000000000000000000001
1011000001110000000000001000000000N0000000000001
101100000000000000000000100000000000000000000001
101100000111000000000000100000000000000000000001
100000000011000001110111100010000000000000000001
111101111111110111000000100000000000000000000001
111101111111110111000000100000000000000000000001
110000001101010111010100100000000000000000000001
10000000000000001100100011D111111111111111111111
10000000000000001100000000001
11111111111111000000000000001
11111111111111000000000000001
10000000000000001111000000001
10000000000000011111000000001
11111111111000000001111110001
10000000000000000001000000001
10000000000000000001010000001
11111111111111111111111111111
