SO ./assets/wall/wall64.png 
WE ./assets/wall/wall64.png
EA ./assets/wall/wall64.png
NO ./assets/wall/wall64.png
C 0,0,0
F 40,40,40

11111
10001
10001     
10D01
10000000001
10001
10001
10001
10001
10001
10001
10001
10001
10001
10001
10001
10001
10001
10001
10001
10001
10001
10001
11E11
11111
11111
10001
11111
