SO ./assets/blossom.png
EA ./assets/flower.png
WE ./assets/night.png
NO ./assets/redbrick.png
F  192,192,192
C  78,60,190


1111111111111111111111111111111111111111111111
1111111111110000000000111111111111111111111111
1111111111111000000000000000000000000011111111
1001100000000000000000000000000000000000000011
1001100000000000000000000000000010000000000011
1001000000000000000000000000000000000000000011
1000000000000000000000000000000000000000000011
1001000000000000000000000000000000000000000011
10000000000000000S0000000000000000000000000011
1001000000000000000000000000000000000000000011
1000000000000000000000000000000000000000000011
1001000000000000000000000000000000000000000011
1000000000000000000000000000000000000000000011
1001000000000000000000000000000000000000000011
1000000000000000000000000000000000000000000011
1001000000000000000000000000000000000000000011
1000000000000000000000000000000000000000000011
1001000000000000000000000000000000000000000011
1000000000000000000000000000000000000000000011
1001100000000000000000000000001111111111111111
1001111111110000000000100001011111111111111111
1000000000000000000001000010111111111111111111
11111111111111111111111111111
