SO ./assets/blossom.png
WE ./assets/redbrick.png
EA ./assets/000.png
NO ./assets/45.png
F 0,0,31
C 0,0,50


1111111111111111111111111111111111111111111111111
1000000000110000000000000000000000000000000000001
101100000111000000000000100000000000000000000001
101100000000000000000000100000000000000000000001
101100000111000000000000100000000000000000000001
1000000000110000011101111000100000000E00000000001
111101111111110111000000100000000000000000000001
111101111111110111000000100000000000000000000001
110000001101010111010100100000000000000000000001
100000000000000011001000100011111111111111111111
10000000000000001101010010001
11000000110101000000000000001
11110111111101000000000000001
10000000001100000100000010001
10000000000000001010000111001
10000000001000010001010101001
10000000001101000000000000001
10000000001100000001010000001
11111111111111111111111111111