SO ./assets/blossom.png
WE ./assets/redbrick.png
EA ./assets/000.png
NO ./assets/45.png
F 0,0,31
C 0,0,50


11111111111111111111111111111
10000000001100000000000000001
10110000011100000000000010001
10110N00000000000000000010001
10110000011100000000000010001
10000000001100000111011110001
11110111111111011100000010001
11110111111111011100000010001
11000000110101011101010010001
10000000000000001100100010001
10000000000000001101010010001
11000000110101000000000000001
11110111111101000000000000001
10000000001100000100000010001
10000000000000001010000111001
10000000001000010001010101001
10000000001101000000000000001
10000000001100000001010000001
11111111111111111111111111111