SO ./assets/so.xpm   
EA ./assets/ea.xpm   
WE ./assets/we.xpm
NO ./assets/no.xpm
F  45,0006,5
C  0,25,51


111111111111111111111111111111
100110000000000000000000000001
100110000000000000000000010001
100100000000000000000000000001
100000000000000000000000000001
100110000000000000000001111111
100111111111000000000010000001
10S000000000000000000100000001
111111111111111111111111111111
