SO ./assets/blossom.png
WE ./assets/redbrick.png
EA ./assets/wood.png
NO ./assets/redbrick.png
F  192,192,192
C  78,60,190


11111111111111111111111111111111111
10000000000000000000000000000000001
10000000000000000001000000000000001
10000000000000000010000000000000001
10000000000000000100000000000000001
10000000000000000000000000000000001
10000000000000000000000000000000001
100000000000000000000000000000000W1
11111111111111111111111111111111111

