SO ./assets/so.xpm   
EA ./assets/ea.xpm   
WE ./assets/we.xpm
NO ./assets/no.xpm
F  192,192,192
C  42,199,216


111111111111111111111111111111111111111111111111111111111111
100110000000000000000000000000000000000000000000000000000111
100110000000000000000000010000000000000000000000000000000111
100100000000000000000000000000000000000000000000000000000111
10000000000000000N000000000011111000000000000000000000000111
100110000000000000000000000000000000000000000000001111111111
100111111111000000000010000000001100000000000000001111111111
100000000000000000001000000000000000000000000011111111111111
111111111111100000000000000000000011111111111111111111111111
111111111111100000011111111111111111111111111111111111111111
100110000000000000000000000001111111111111111111111111111111
100110000000000000000000010001111111111111111111111111111111
100100000000000000000000000001111111111111111111111111111111
100000000000000000000000000001111111111111111111111111111111
100110000000000000000001111111111111111111111111111111111111
100111111111000000000010000001111111111111111111111111111111
100000000000000000000100000001111111111111111111111111111111
1111111111110000000000111111111
1111111111111000000000011111111
1001100000000000000000000000011
1001100000000000000000000100011
1001000000000000000000000000011
1000000000000000000000000000011
1001100000000000000000011111111
1001111111110000000000100001011
1000000000000000000001000010111
11111111111111111111111111111


