SO ./assets/so.xpm   
EA ./assets/ea.xpm   
WE ./assets/we.xpm
NO ./assets/no.xpm
F  45,0006,5
C  0,25,51
11111111111
10000000001
11011011101
11011011101
11011011101
11011011101
11000000001
11100111111
11100111111
111N1111111
11111111111





