        SO        lolo
             F   	     45 ,      32,    132
   EA ./assets/ea.xpm   
C	0,25,51
WE ./assets/we.xpm

NO      ./assets/no.xpm



1111111111111111111111111111111
1100000000000000000000000111111
1000000001111111111111100011111
1100000011111111111111100101111
1111100000000000000000001011111
11111000000000000000000S0111111
1111111111000111111111111111111
1000000000000000000000111111111
1100000011111111111100000001111
1111111111111111111111111111111