        SO        lolo
             F   	     45 ,      32,    132
   EA ./assets/ea.xpm   
C	0,25,51
WE ./assets/we.xpm

NO      ./assets/no.xpm


111111111   11111
111111111111111111111
11111100001111111110111111
110000010000000001111111111111
110000010000000000000001110011
1111111111111111000000001111111
11111111111   1000000000011
1111111   111100000000011111111
1111111111    1111111111100000111111
11111100011111111111111111111111
1111111111111111111111111111111
1111111111111111111111111111111