        SO        lolo
   EA ./assets/ea.xpm
WE ./assets/we.xpm
NO      ./assets/no.xpm

                F	          32,       32,  32
C	0,25,51


111111111       11111
     111111111111111111111
1111110000111111111001
1100000100000000001111111111111
1100000100000000000000001110011
1111111111111111000000001110011
1111111        1111000000000011
1111111        1111000000000010
1111111111111111111000001111111
               1111110001111111111111100111111
1111111111111111111111111111111

