SO ./assets/so.xpm   
EA ./assets/ea.xpm   
WE ./assets/we.xpm
NO ./assets/no.xpm
F  45,0006,5
C  0,25,51
11111111111
10000000001
11011011101
11011011101
11011011101
11011011101
11000000001
11100111111
11100111111
111N1111111
11111111111






1111111111111111111111111111111
1100000000000000000000000111111
1000000001111111111111100011111
1100000011111111111111100111111
1111100000000000000000000111111
11111000000000000000S0000111111
1111111111000111111111111111111
1000000000000000000000111111111
1100000011111111111100000001111
1111111111111111111111111111111